|||#################################||||#######################################|||
|                                                                                |
|                                                               #                |
#                                                               #                #
#                                                               #                #
#                                                               #                #
#         #######                                               #                #
#                               #############                   #                #
#                                           #                   #                #
#                                           #                   #                #
#                                           #                   #                #
#                                           #                   #                #
|                                           #                   #                |
|                                           #                   #                |
|                                           #                   ######           |
#                                           #                                    #
#                                                                                #
#                                                                                #
#                                                                                #
#                 ######################                                         #
#                                                                                #
#                                                                                #
#                                                                                #
|                                                                                |
|                                                                                |
|||#################################||||#######################################|||
